0,0,0,0,0,1,1,1
0,0,0,0,0,0,0,1
1,1,0,0,0,0,0,1
6,8,10,0,0,0,0,0,1
1,1,0,0,0,0,7,10,1
0,0,0,0,0,0,0,1
0,0,0,0,0,0,0,1
0,0,0,0,0,0,0,1
0,0,0,0,0,0,0,1
0,0,0,0,0,0,0,1
0,0,0,0,0,0,7,11,1
0,0,0,0,0,0,6,1
0,0,0,0,0,0,0,1
0,1,1,1,1,8,11,8,11,1
1,1,1,0,0,0,2,1
1,1,1,0,0,0,7,12,1
1,1,1,0,0,0,0,1
1,1,1,0,0,0,0,1
1,1,1,1,1,8,12,8,12,1
1,1,0,0,0,0,0,1
1,0,0,0,0,0,0,1
1,0,0,0,0,0,2,1
1,0,0,0,0,0,0,1
1,0,0,0,0,0,6,1
1,0,0,0,0,0,0,1
1,1,0,0,0,0,0,1
1,1,1,1,1,1,1,1