0,0,0,1,1,1,1,1
0,0,0,0,1,1,1,1
0,0,0,0,0,1,1,1
0,0,1,0,0,0,1,1
0,0,1,0,0,0,0,1
0,0,0,0,0,0,0,1
0,0,0,0,0,0,0,1
0,0,1,0,0,0,0,1
0,0,1,0,0,0,0,1
0,0,1,1,1,8,102,8,102,1
0,0,1,0,0,0,0,1
0,0,1,4,4,0,6,1
0,0,1,4,4,0,7,103,1
0,0,1,0,0,0,0,1
0,0,1,1,1,8,103,8,103,1
0,6,1,0,0,0,0,1
1,0,0,0,0,0,7,102,1
0,0,0,0,0,0,0,1
0,0,0,0,0,0,0,1
0,0,0,0,0,0,7,104,1
0,0,0,0,0,0,0,1
0,0,0,0,0,0,1,1
0,0,0,0,0,1,1,1
0,0,0,0,1,1,1,1
0,0,0,0,1,1,1,1
0,0,0,1,1,0,5,1
0,0,0,1,4,4,4,1
0,0,0,1,4,4,4,1
0,0,1,1,4,4,4,1
0,0,1,1,8,104,8,104,1,1
0,0,1,0,0,0,1,1
0,0,1,0,0,0,3,3
0,0,1,0,0,0,3,3
0,0,1,0,0,0,3,3
0,0,0,0,0,0,3,3
0,0,0,0,0,0,3,3
0,0,0,1,0,0,3,3
0,0,6,1,0,0,3,3
0,0,0,1,0,0,1,3
0,0,0,0,0,0,7,105,1
0,0,0,0,0,0,0,1
0,0,0,8,105,0,1,1,3
0,0,0,0,0,0,3,3
0,0,0,0,0,0,3,3
0,0,0,1,0,0,3,3
0,0,1,0,0,0,3,3
0,0,0,0,0,0,3,3
0,0,1,0,0,0,3,3
0,4,0,0,0,0,3,3
0,4,0,1,0,0,3,3
0,4,0,0,0,0,3,3
0,0,1,0,0,0,3,3
0,0,0,1,0,0,3,3
0,0,0,1,0,0,3,3
0,0,0,0,0,0,3,3
0,0,0,0,0,0,3,3
0,0,0,4,1,0,3,3
0,0,0,0,0,1,1,3
0,0,0,0,0,0,1,1
0,0,0,0,0,0,1,1
0,0,0,0,4,2,1,1
0,0,0,0,4,0,1,1
0,0,0,0,4,0,1,1
0,0,0,0,0,0,1,1
0,0,0,0,0,0,1,1
0,0,0,0,0,1,1,1
0,0,0,0,0,0,1,1
0,0,0,0,0,0,1,1
0,0,0,0,0,0,7,107,1
0,0,0,0,0,8,108,1,1
0,0,0,0,0,0,1,1
0,0,0,0,0,6,1,1
0,0,0,0,0,0,7,108,1
1,1,0,0,0,0,1,1
6,8,108,0,0,0,0,1,1
1,1,0,0,0,0,1,1
1,1,1,8,107,8,107,1,1,1
1,1,4,4,4,1,1,1
1,4,4,4,4,4,1,1
1,4,4,4,4,4,1,1
1,4,4,4,4,1,1,1
1,4,4,4,1,1,1,1
1,1,4,4,8,107,0,0,1
1,1,1,1,1,0,4,1
1,1,1,1,0,4,0,1
1,1,1,0,4,0,0,1
1,1,0,4,0,0,1,1
1,1,4,0,0,1,1,1
1,1,0,0,0,1,1,1
1,1,0,0,6,1,1,1
0,0,0,0,0,0,3,3
0,0,0,0,0,0,1,3
0,0,0,0,0,0,3,3
0,0,0,0,0,1,3,3
0,0,0,0,0,0,3,3
0,0,0,0,4,1,3,3
0,0,0,0,4,1,3,3
0,0,0,4,1,0,3,3
0,0,0,0,0,0,3,3
0,0,0,0,1,1,1,1
0,0,0,1,1,1,1,1
0,0,0,0,0,0,3,3
0,0,0,0,0,0,3,3
0,0,0,0,0,1,1,3
0,0,0,0,0,1,1,3
0,0,0,0,1,2,2,1
0,0,0,1,1,2,2,1
0,0,1,1,1,8,109,8,109,1
0,0,1,4,4,0,0,1
0,0,1,4,4,0,5,1
0,0,8,109,4,4,0,0,1
0,0,1,4,4,0,0,1
0,0,1,1,1,1,1,1
0,0,0,0,7,110,1,7,109,1
0,0,1,1,1,4,4,1
0,0,1,6,8,111,4,4,1
0,6,1,1,1,4,4,1
0,0,0,1,1,4,4,1
0,0,0,7,111,1,4,4,1
0,0,0,1,1,8,110,8,110,1
0,0,0,0,0,0,0,1
4,1,0,0,0,0,1,1
4,1,0,0,0,1,1,1
0,0,0,0,1,1,1,1
0,0,0,1,1,1,1,1
0,0,1,1,1,1,1,3
0,0,3,3,3,3,3,3
0,0,3,3,3,3,3,3
0,0,3,3,3,3,3,3
0,0,3,3,3,3,3,3
0,0,3,3,3,3,3,3
0,0,3,3,3,3,3,3
0,0,3,3,3,3,3,3
0,0,3,3,3,3,3,3
0,0,3,3,3,3,3,3
0,0,3,3,3,3,3,3
0,0,0,0,0,0,0,0
0,0,0,0,0,0,0,0
0,0,0,0,0,0,0,0
0,0,0,0,0,0,0,0
0,0,0,0,0,0,0,0
