0,0,0,0,5,1,1,1
0,0,0,0,0,0,3,1
0,0,0,0,0,4,1,1
0,0,0,0,0,0,2,1
0,0,0,0,0,0,0,1
0,0,0,0,0,0,1,1
0,0,0,0,0,0,0,1
0,0,0,0,0,0,6,1
0,0,0,0,0,0,1,1
0,0,0,0,0,0,6,1
0,0,0,0,0,0,0,1
0,0,0,0,0,0,0,1
0,0,0,0,0,0,0,1
8,10,0,0,0,0,0,0,1
0,0,0,0,0,0,7,10,1
0,0,0,0,0,0,7,11,1
8,11,0,0,0,0,0,0,1
0,0,0,0,0,0,0,1